1000100101011011011010111010100101010000000010
0000001100000010011001011001010110101000100001
1000010000011100100100001111001111001110010110
1010001011100101110010111010111001111110010101
0001011110000111010101010010001110011111111000
0111011110111101101010000010010100100110101111
0000101101010100111011110000101011010010011001
1101110110100000000100111110110100101001100111
1001010110101100111010110110111111110000111101
0000011011110011100011100001101010011100100010
1011110000010111000000011110010110001000100101
1000101001101001010101101110010001000010011110
1111000000001000100010111000010001010000101101
1010000001101010011111001011001111010011101111
0100101011100010101101101101000001110110011011
0111000110010110000010000100100111110000111010
0011110101100101010100110011010010010110110101
0011000100000000001010001010001001000110101101
0110011101001010011001010010010000101010011011
1001011011000001011100111110000010100101101010
0101100111110010000011101101110100001000011000
0100100000110110100101100111110110101000100010
1000101001001010100100010000110001001101110101
1101100100001110110111111110011001011110011101
0110110000101100000001010100101001101010100011
