101010101010101010101010101010101010101010101
001010001010100010101010001010101010101000100
111110101110101110111110101010111011101110111
000000100000100000000000100000000010000000000
101111111110111011111110111111101110111111111
000000001000001010100000100000100010100010100
111111111011101111101010111110111011101111101
000000001010001000100000101000101010100000100
111110111011111010111111111010101010101010111
001010100000100010101010001000101010001000100
111011111110101010111010101010101110101110111
001000000000001010101000001000100010001000100
101111111111111111101111101110111110111111111
000000001010000000001010100010000010000000000
111010111010111010101011111011111110111011111
001010001000100000000000001010100010101010000
101110101010101111111111101110111110101011111
000010001010101000000000000010001000101010000
111110111011101011111111111010101111101011101
001000100010101010101000100000000000000010100
101110111010101110101110111111111011111011101
001010101010001000100010101000000010100010100
111011111010111111101010101111111011101111101
000010000010100010101000101010101000001000100
101010101010101010101010101010101010101010101